7,6,,,,,
,M,,,,,
,M,,M,M,,M
,M,,M,,,
,,,,M,M,
,M,,M,,,
,M,,,,M,
